00000000000000000000000000000000000000000000000000000000000000000000000000000000000000000000000000000000000000000000000000000000000000000000000000000000000000000000000000000000000000000000000000000000000000000000000000000000000000000000000000000000000000000000
00000000000000000000000000000000000000000000000000000000000000000000000000000000000000000000000000000000000000000000000000000000000000000000000000000000000000000000000000000000000000000000000000000000000000000000000000000000000000000000000000000000000000000000
00000000000000000000000000000000000000000000000000000000000000000000000000000000000000000000000000000000000000000000000000000000000000000000000000000000000000000000000000000000000000000000000000000000000000000000000000000000000000000000000000000000000000000000   
00000000000000000000000000000000000000000000000000000000000000000000000000000000000000000000000000000000000000000000000000000000000000000000000000000000000000000000000000000000000000000000000000000000000000000000000000000000000000000000000000000000000000000000
00000000000000000000000000000000000000000000000000000000000000000000000000000000000000000000000000000000000000000000000000000000000000000000000000000000000000000000000000000000000000000000000000000000000000000000000000000000000000000000000000000000000000000000   
00000000000000000000000000000000000000000000000000000000000000000000000000000000000000000000000000000000000000000000000000000000000000000000000000000000000000000000000000000000000000000000000000000000000000000000000000000000000000000000000000000000000000000000
10000000000000000000010000000000000000000000000000000000000000000000000000000000000000000000000000000000000000000000000000000000000000000000000011000000000110000000000000000000000000000000000000000000000000000000000000000000000000000000000000000000000000000001   
20000000000000000000000000000000111100000000000000000000000000000000000000000000000000000000000000000111000000000000000000000000000000000000000122100000110000000000000000000000000000000000000000000000000000000000000000000000000000000000000000000000000000000002
20000000000000000100000000111100000000000000000000000000011000000000000000001111000000000000000110000000000000000000000000000000000000000000001222200000000000000000000000000000000000000000000000000000000000000000000000000000000000000000000000000000000000000002   
20000000000000001010000000000000000000000000000000000000000000000000000000000000000000000000001221000000000000000000000000000000000000000000012222211000000000000000000000100000000000000000000000000000000000000000000000000000000000000000000000000000000000000002
21111111111111112221111111111111111111111111111111111110000001111111111111111111111111111111112222111111111111111111111000111111111111111111222222222111111111000000011111211111111111111111111111111111111111111111111111111111111111111111111111111111111111111112
22222222222222222222222222222222222222222222222222222220000002222000022222222222222222222222222222222222222222222222222200000000002222222222222222222222222222200002222222222222222222222222222222222222222222222222222222222222222222222222222222222222222222222222
22222222222222222222222222222222222222222222222222222222200000000000022222222222222222222222222222222222222222222222222200000000002222222222222222222222222222222222222222222222222222222222222222222222222222222222222222222222222222222222222222222222222222222222
22222222222222222222222222222222222222222222222222222222200000000000222222222222222222222222222222222222222222222222222222002200022222222222222222222222222222222222222222222222222222222222222222222222222222222222222222222222222222222222222222222222222222222222
22222222222222222222222222222222222222222222222222222222222222000020000222222222222222222222222222222222222222222222222222222222222222222222222222222222222222222222222222222222222222222222222222222222222222222222222222222222222222222222222222222222222222222222
22222222222222222222222222222222222222222222222222222222222222222222222222222222222222222222222222222222222222222222222222222222222222222222222222222222222222222222222222222222222222222222222222222222222222222222222222222222222222222222222222222222222222222222


                